//MAP CONVERTED BY dmm2tgm.py THIS HEADER COMMENT PREVENTS RECONVERSION, DO NOT REMOVE
"al" = (
/obj/effect/turf_decal/stripes/line,
/obj/structure/sign/departments/restroom/directional/south,
/obj/structure/tank_holder/extinguisher,
/turf/open/floor/mineral/titanium/tiled,
/area/shuttle/abandoned/bar)
"aS" = (
/obj/effect/turf_decal/tile/neutral/fourcorners,
/obj/effect/turf_decal/stripes/line{
	dir = 8
	},
/obj/effect/turf_decal/stripes/line{
	dir = 4
	},
/obj/structure/cable,
/obj/machinery/atmospherics/components/unary/vent_pump/on{
	dir = 1
	},
/turf/open/floor/iron/dark,
/area/shuttle/abandoned/cargo)
"aV" = (
/obj/machinery/atmospherics/pipe/smart/manifold4w/supply/hidden,
/obj/effect/turf_decal/siding/thinplating_new/light{
	dir = 4
	},
/turf/open/floor/mineral/titanium/tiled/white,
/area/shuttle/abandoned/crew)
"aY" = (
/obj/structure/window/reinforced/shuttle,
/turf/open/floor/plating,
/area/shuttle/abandoned/bar)
"ba" = (
/obj/structure/sign/departments/engineering/directional/west,
/obj/effect/turf_decal/bot/right,
/obj/structure/safe,
/obj/machinery/light/small/directional/west,
/turf/open/floor/mineral/plastitanium,
/area/shuttle/abandoned/bar)
"bQ" = (
/obj/machinery/computer/communications,
/turf/open/floor/mineral/titanium/tiled/blue,
/area/shuttle/abandoned/bridge)
"bV" = (
/obj/structure/fans/tiny/forcefield,
/obj/machinery/door/poddoor{
	name = "Cargo Loading Door";
	id = "cargo_whitesship"
	},
/turf/open/floor/plating,
/area/shuttle/abandoned/cargo)
"ct" = (
/turf/open/floor/plating,
/area/shuttle/abandoned/engine)
"cQ" = (
/obj/machinery/door/airlock/corporate{
	name = "Private Quarters";
	id = "quarters"
	},
/obj/structure/cable,
/obj/machinery/atmospherics/pipe/smart/manifold4w/supply/hidden,
/turf/open/floor/mineral/titanium/tiled,
/area/shuttle/abandoned/crew)
"fH" = (
/obj/machinery/button/door/directional/north{
	id = "bath_whiteship";
	name = "Bathroom Bolt Control";
	specialfunctions = 4;
	normaldoorcontrol = 1
	},
/obj/structure/toilet{
	dir = 4
	},
/mob/living/simple_animal/hostile/nanotrasen,
/turf/open/floor/mineral/titanium/tiled/white,
/area/shuttle/abandoned/crew)
"fM" = (
/obj/structure/cable,
/obj/machinery/atmospherics/pipe/smart/manifold4w/supply/hidden,
/turf/open/floor/mineral/plastitanium,
/area/shuttle/abandoned/bar)
"ge" = (
/obj/effect/turf_decal/tile/neutral/fourcorners,
/obj/effect/turf_decal/stripes/line{
	dir = 8
	},
/obj/effect/turf_decal/stripes/line{
	dir = 4
	},
/turf/open/floor/iron/dark,
/area/shuttle/abandoned/cargo)
"gf" = (
/turf/open/floor/mineral/titanium/tiled/blue,
/area/shuttle/abandoned/medbay)
"gl" = (
/turf/closed/wall/mineral/titanium,
/area/shuttle/abandoned/crew)
"gn" = (
/turf/open/floor/carpet/royalblue,
/area/shuttle/abandoned/crew)
"gy" = (
/obj/effect/turf_decal/stripes/line{
	dir = 1
	},
/obj/structure/table,
/obj/machinery/microwave{
	pixel_y = 7
	},
/obj/machinery/airalarm/directional/north,
/obj/effect/mapping_helpers/airalarm/all_access,
/obj/machinery/light/directional/north,
/turf/open/floor/mineral/titanium/tiled,
/area/shuttle/abandoned/bar)
"hj" = (
/obj/structure/cable,
/obj/machinery/atmospherics/pipe/smart/manifold4w/supply/hidden,
/turf/open/floor/mineral/titanium/tiled,
/area/shuttle/abandoned/bar)
"ht" = (
/turf/closed/wall/mineral/titanium,
/area/shuttle/abandoned/bar)
"hK" = (
/obj/machinery/computer/monitor{
	dir = 8
	},
/turf/open/floor/mineral/titanium/tiled/blue,
/area/shuttle/abandoned/bridge)
"ij" = (
/obj/machinery/atmospherics/components/unary/vent_pump/on{
	dir = 1
	},
/turf/open/floor/mineral/titanium/tiled,
/area/shuttle/abandoned/bridge)
"ip" = (
/obj/effect/turf_decal/stripes/line{
	dir = 4
	},
/obj/structure/cable,
/obj/machinery/atmospherics/pipe/smart/manifold4w/supply/hidden,
/turf/open/floor/mineral/titanium/tiled,
/area/shuttle/abandoned/bar)
"jE" = (
/obj/structure/bed{
	dir = 4
	},
/obj/item/bedsheet/medical{
	dir = 4
	},
/obj/machinery/airalarm/directional/north,
/obj/effect/mapping_helpers/airalarm/all_access,
/turf/open/floor/mineral/titanium/tiled/blue,
/area/shuttle/abandoned/medbay)
"jF" = (
/obj/machinery/door/airlock/external{
	name = "External Access"
	},
/obj/machinery/atmospherics/pipe/smart/manifold4w/supply/hidden,
/turf/open/floor/mineral/titanium,
/area/shuttle/abandoned/bar)
"ku" = (
/obj/machinery/atmospherics/pipe/smart/manifold4w/supply/hidden,
/obj/structure/chair/stool/directional/south,
/obj/structure/extinguisher_cabinet/directional/east,
/obj/machinery/light/small/directional/east,
/turf/open/floor/plating,
/area/shuttle/abandoned/engine)
"kO" = (
/obj/structure/chair/comfy/shuttle{
	dir = 4
	},
/obj/effect/turf_decal/stripes/line{
	dir = 4
	},
/mob/living/simple_animal/hostile/nanotrasen{
	name = "\improper Nanotrasen Private Security Pilot"
	},
/turf/open/floor/mineral/titanium/tiled,
/area/shuttle/abandoned/bridge)
"kZ" = (
/obj/machinery/computer/camera_advanced/shuttle_docker/whiteship{
	dir = 1;
	view_range = 14;
	x_offset = -4;
	y_offset = -8
	},
/obj/machinery/firealarm/directional/west,
/turf/open/floor/mineral/titanium/tiled/blue,
/area/shuttle/abandoned/bridge)
"la" = (
/obj/structure/window/reinforced/shuttle,
/obj/machinery/door/poddoor/preopen{
	id = "whiteship_blast"
	},
/turf/open/floor/plating,
/area/shuttle/abandoned/bridge)
"lc" = (
/turf/open/floor/mineral/titanium/yellow,
/area/shuttle/abandoned/bar)
"ly" = (
/obj/effect/turf_decal/stripes/line{
	dir = 5
	},
/turf/open/floor/mineral/titanium/tiled,
/area/shuttle/abandoned/bridge)
"lI" = (
/obj/machinery/power/shuttle_engine/propulsion/left{
	dir = 8
	},
/turf/open/floor/plating,
/area/shuttle/abandoned/engine)
"lL" = (
/obj/structure/window/reinforced/shuttle,
/obj/effect/turf_decal/stripes/line{
	dir = 1
	},
/obj/machinery/door/poddoor/preopen{
	id = "whiteship_blast"
	},
/turf/open/floor/plating,
/area/shuttle/abandoned/bridge)
"lR" = (
/obj/structure/table/reinforced,
/obj/item/storage/box/syringes,
/obj/item/clothing/gloves/latex/nitrile,
/obj/item/clothing/mask/surgical,
/obj/item/reagent_containers/cup/bottle/adminordrazine,
/obj/machinery/power/apc/auto_name/directional/north,
/obj/structure/cable,
/turf/open/floor/mineral/titanium/tiled/white,
/area/shuttle/abandoned/medbay)
"mg" = (
/obj/effect/turf_decal/stripes/line,
/obj/effect/turf_decal/stripes/line{
	dir = 1
	},
/obj/machinery/atmospherics/pipe/smart/manifold4w/supply/hidden,
/obj/machinery/door/airlock/vault{
	name = "Ship Engine"
	},
/obj/structure/cable,
/turf/open/floor/mineral/titanium/tiled,
/area/shuttle/abandoned/bar)
"mC" = (
/obj/structure/table/reinforced,
/obj/machinery/recharger,
/obj/item/restraints/handcuffs,
/obj/item/gun/energy/e_gun,
/turf/open/floor/mineral/titanium/tiled/blue,
/area/shuttle/abandoned/bridge)
"mM" = (
/obj/structure/chair/comfy/shuttle,
/obj/effect/turf_decal/stripes/line,
/obj/structure/closet/emcloset/wall{
	pixel_x = -30
	},
/obj/machinery/light/directional/west,
/mob/living/simple_animal/hostile/nanotrasen/ranged/smg,
/turf/open/floor/mineral/titanium/tiled,
/area/shuttle/abandoned/bridge)
"mS" = (
/obj/structure/table/wood,
/obj/item/flashlight/lamp{
	pixel_x = -3;
	pixel_y = 13
	},
/turf/open/floor/carpet/royalblue,
/area/shuttle/abandoned/crew)
"pc" = (
/obj/structure/bed/double,
/obj/item/bedsheet/cosmos/double,
/obj/machinery/airalarm/directional/south,
/obj/effect/mapping_helpers/airalarm/all_access,
/turf/open/floor/carpet/royalblue,
/area/shuttle/abandoned/crew)
"pr" = (
/obj/machinery/portable_atmospherics/canister/oxygen,
/obj/effect/turf_decal/bot_blue,
/turf/open/floor/plating,
/area/shuttle/abandoned/engine)
"px" = (
/obj/machinery/power/terminal{
	dir = 4
	},
/obj/machinery/power/port_gen/pacman{
	anchored = 1
	},
/obj/item/wrench,
/turf/open/floor/plating,
/area/shuttle/abandoned/engine)
"qs" = (
/obj/structure/closet/crate/internals,
/obj/effect/turf_decal/box/corners{
	dir = 1
	},
/obj/effect/turf_decal/box/corners{
	dir = 4
	},
/obj/item/tank/internals/oxygen,
/obj/item/tank/internals/oxygen,
/obj/item/tank/internals/oxygen,
/obj/item/clothing/mask/gas,
/obj/item/clothing/mask/gas,
/obj/item/clothing/mask/gas,
/obj/machinery/airalarm/directional/north,
/obj/effect/mapping_helpers/airalarm/all_access,
/obj/machinery/light/directional/north,
/turf/open/floor/iron/dark,
/area/shuttle/abandoned/cargo)
"qA" = (
/obj/structure/rack,
/obj/effect/turf_decal/bot/left,
/obj/item/wrench,
/obj/item/crowbar/red/caravan,
/obj/item/storage/toolbox/emergency,
/obj/machinery/firealarm/directional/north,
/turf/open/floor/iron/dark,
/area/shuttle/abandoned/bar)
"qI" = (
/obj/structure/cable,
/obj/machinery/atmospherics/pipe/smart/manifold4w/supply/hidden,
/turf/open/floor/mineral/titanium/tiled,
/area/shuttle/abandoned/bridge)
"rd" = (
/obj/machinery/iv_drip,
/obj/machinery/light/directional/south,
/turf/open/floor/mineral/titanium/tiled/white,
/area/shuttle/abandoned/medbay)
"rg" = (
/obj/effect/turf_decal/bot/left,
/obj/machinery/portable_atmospherics/canister/air,
/obj/machinery/firealarm/directional/east,
/obj/structure/extinguisher_cabinet/directional/north,
/obj/machinery/light/small/directional/east,
/turf/open/floor/mineral/plastitanium,
/area/shuttle/abandoned/bar)
"rA" = (
/obj/structure/sign/departments/cargo/directional/south,
/obj/effect/turf_decal/bot/right,
/obj/structure/filingcabinet,
/obj/structure/closet/emcloset/wall{
	pixel_x = 30
	},
/obj/machinery/light/small/directional/east,
/turf/open/floor/mineral/plastitanium,
/area/shuttle/abandoned/bar)
"rB" = (
/obj/structure/closet/crate/engineering,
/obj/machinery/power/apc/auto_name/directional/west,
/obj/item/clothing/gloves/color/yellow,
/obj/item/clothing/gloves/color/yellow,
/obj/item/stack/sheet/mineral/plasma/thirty,
/obj/item/stack/sheet/mineral/plasma/thirty,
/obj/item/storage/belt/utility/full/powertools/ircd,
/obj/item/storage/belt/utility/full/powertools/ircd,
/obj/effect/turf_decal/box/corners{
	dir = 4
	},
/obj/effect/turf_decal/box/corners{
	dir = 1
	},
/obj/structure/cable,
/turf/open/floor/iron/dark,
/area/shuttle/abandoned/cargo)
"rR" = (
/obj/machinery/portable_atmospherics/scrubber,
/obj/effect/turf_decal/bot,
/obj/machinery/airalarm/directional/north,
/obj/effect/mapping_helpers/airalarm/all_access,
/turf/open/floor/plating,
/area/shuttle/abandoned/engine)
"rU" = (
/mob/living/simple_animal/hostile/nanotrasen/ranged/smg,
/turf/open/floor/plating,
/area/shuttle/abandoned/engine)
"rZ" = (
/obj/machinery/power/shuttle_engine/heater{
	dir = 8
	},
/obj/structure/window/reinforced/spawner/directional/east,
/turf/open/floor/plating,
/area/shuttle/abandoned/engine)
"uj" = (
/obj/structure/sign/nanotrasen,
/turf/closed/wall/mineral/titanium,
/area/shuttle/abandoned/bar)
"ur" = (
/obj/structure/chair/comfy/shuttle{
	dir = 1
	},
/obj/effect/turf_decal/stripes/line{
	dir = 1
	},
/obj/structure/closet/firecloset/wall{
	pixel_y = 0;
	pixel_x = -28
	},
/obj/machinery/light/directional/west,
/mob/living/simple_animal/hostile/nanotrasen/ranged/smg,
/turf/open/floor/mineral/titanium/tiled,
/area/shuttle/abandoned/bridge)
"uy" = (
/obj/effect/turf_decal/stripes/line{
	dir = 9
	},
/obj/item/kirbyplants/random,
/obj/machinery/power/apc/auto_name/directional/north,
/obj/structure/cable,
/obj/machinery/light/small/directional/west,
/turf/open/floor/mineral/titanium/tiled,
/area/shuttle/abandoned/bar)
"uU" = (
/obj/machinery/power/shuttle_engine/propulsion/right{
	dir = 8
	},
/turf/open/floor/plating,
/area/shuttle/abandoned/engine)
"vi" = (
/obj/machinery/atmospherics/components/tank/air{
	dir = 1
	},
/obj/effect/turf_decal/delivery,
/turf/open/floor/plating,
/area/shuttle/abandoned/engine)
"vr" = (
/obj/structure/window/reinforced/shuttle,
/obj/machinery/door/poddoor/preopen{
	id = "bath_shutter"
	},
/turf/open/floor/plating,
/area/shuttle/abandoned/crew)
"vE" = (
/obj/machinery/door/airlock/medical{
	name = "Bathroom";
	id = "bath_whiteship"
	},
/turf/open/floor/mineral/titanium/tiled/white,
/area/shuttle/abandoned/crew)
"vN" = (
/obj/structure/table/reinforced,
/obj/item/folder{
	pixel_y = 2;
	pixel_x = -4
	},
/obj/item/folder/white,
/turf/open/floor/mineral/titanium/tiled/blue,
/area/shuttle/abandoned/bridge)
"wi" = (
/obj/effect/turf_decal/stripes/line,
/obj/machinery/atmospherics/pipe/smart/manifold4w/supply/hidden,
/turf/open/floor/mineral/titanium/tiled,
/area/shuttle/abandoned/bar)
"wu" = (
/obj/effect/turf_decal/stripes/line{
	dir = 1
	},
/obj/effect/turf_decal/stripes/line,
/obj/machinery/atmospherics/pipe/smart/manifold4w/supply/hidden,
/obj/structure/cable,
/mob/living/simple_animal/hostile/nanotrasen,
/turf/open/floor/mineral/titanium/tiled,
/area/shuttle/abandoned/bar)
"wN" = (
/obj/machinery/atmospherics/pipe/smart/manifold4w/supply/hidden,
/turf/open/floor/plating,
/area/shuttle/abandoned/engine)
"zg" = (
/obj/machinery/door/airlock/mining{
	name = "Cargo Compartment"
	},
/obj/effect/turf_decal/tile/neutral/fourcorners,
/obj/effect/turf_decal/stripes/line{
	dir = 8
	},
/obj/effect/turf_decal/stripes/line{
	dir = 4
	},
/obj/structure/cable,
/obj/machinery/atmospherics/pipe/smart/manifold4w/supply/hidden,
/turf/open/floor/iron/dark,
/area/shuttle/abandoned/cargo)
"zi" = (
/obj/effect/turf_decal/tile/neutral/fourcorners,
/obj/machinery/atmospherics/components/unary/vent_pump/on,
/turf/open/floor/iron/dark,
/area/shuttle/abandoned/bar)
"Am" = (
/turf/closed/wall/mineral/titanium,
/area/shuttle/abandoned/bridge)
"AF" = (
/turf/closed/wall/mineral/titanium,
/area/shuttle/abandoned/medbay)
"Bk" = (
/obj/structure/window/reinforced/shuttle,
/obj/machinery/door/poddoor/preopen{
	id = "quart_shutter"
	},
/turf/open/floor/plating,
/area/shuttle/abandoned/crew)
"Bn" = (
/obj/machinery/power/apc/auto_name/directional/west,
/obj/structure/cable,
/obj/machinery/atmospherics/components/unary/vent_pump/on,
/turf/open/floor/mineral/titanium/tiled,
/area/shuttle/abandoned/bridge)
"BQ" = (
/obj/machinery/atmospherics/components/unary/vent_pump/on{
	dir = 4
	},
/obj/structure/closet/emcloset/anchored,
/obj/machinery/light/small/directional/south,
/turf/open/floor/mineral/titanium/yellow,
/area/shuttle/abandoned/bar)
"BS" = (
/obj/structure/chair/office{
	dir = 1
	},
/obj/machinery/button/door/directional/south{
	id = "quart_shutter";
	name = "Privacy Shutters Control";
	pixel_x = 7
	},
/turf/open/floor/carpet/royalblue,
/area/shuttle/abandoned/crew)
"Cy" = (
/obj/effect/turf_decal/stripes/line{
	dir = 6
	},
/turf/open/floor/mineral/titanium/tiled,
/area/shuttle/abandoned/bridge)
"CR" = (
/obj/machinery/atmospherics/pipe/smart/manifold4w/supply/hidden,
/obj/machinery/meter,
/obj/structure/cable,
/turf/open/floor/plating,
/area/shuttle/abandoned/engine)
"Db" = (
/obj/structure/table/reinforced,
/obj/item/storage/medkit/regular,
/obj/item/healthanalyzer,
/obj/machinery/firealarm/directional/east,
/obj/machinery/light/small/directional/east,
/turf/open/floor/mineral/titanium/tiled/blue,
/area/shuttle/abandoned/medbay)
"Dc" = (
/obj/structure/sign/warning/docking,
/turf/closed/wall/mineral/titanium,
/area/shuttle/abandoned/bar)
"Dt" = (
/obj/machinery/door/airlock/external{
	name = "External Access"
	},
/turf/open/floor/mineral/titanium,
/area/shuttle/abandoned/bar)
"DA" = (
/turf/open/floor/mineral/titanium/tiled/white,
/area/shuttle/abandoned/medbay)
"DF" = (
/obj/effect/turf_decal/stripes/line{
	dir = 1
	},
/obj/structure/table,
/obj/item/storage/fancy/donut_box{
	pixel_y = 7
	},
/turf/open/floor/mineral/titanium/tiled,
/area/shuttle/abandoned/bar)
"DL" = (
/obj/structure/sink/directional/east,
/obj/structure/mirror/directional/west,
/obj/machinery/light/small/directional/south,
/turf/open/floor/mineral/titanium/tiled/white,
/area/shuttle/abandoned/crew)
"DM" = (
/turf/open/floor/mineral/titanium,
/area/shuttle/abandoned/bar)
"Eu" = (
/obj/effect/turf_decal/stripes/line{
	dir = 1
	},
/obj/machinery/atmospherics/pipe/smart/manifold4w/supply/hidden,
/turf/open/floor/mineral/titanium/tiled,
/area/shuttle/abandoned/bar)
"FL" = (
/turf/closed/wall/mineral/titanium,
/area/shuttle/abandoned/cargo)
"FQ" = (
/obj/machinery/door/airlock/ce{
	name = "Ship Bridge";
	id = "whiteship_bridge"
	},
/obj/structure/cable,
/obj/machinery/atmospherics/pipe/smart/manifold4w/supply/hidden,
/turf/open/floor/mineral/titanium/tiled,
/area/shuttle/abandoned/bar)
"FX" = (
/obj/effect/turf_decal/stripes/line,
/obj/structure/chair{
	dir = 8
	},
/turf/open/floor/mineral/titanium/tiled,
/area/shuttle/abandoned/bar)
"GM" = (
/mob/living/simple_animal/hostile/nanotrasen,
/turf/open/floor/mineral/titanium/yellow,
/area/shuttle/abandoned/bar)
"IF" = (
/obj/machinery/computer/shuttle/white_ship/bridge{
	dir = 8
	},
/turf/open/floor/mineral/titanium/tiled/blue,
/area/shuttle/abandoned/bridge)
"Jj" = (
/obj/machinery/computer/monitor{
	dir = 1
	},
/obj/machinery/firealarm/directional/east,
/turf/open/floor/plating,
/area/shuttle/abandoned/engine)
"Jq" = (
/obj/structure/sign/warning/directional/south,
/obj/structure/sign/warning/directional/west,
/obj/effect/turf_decal/bot/left,
/obj/structure/closet/crate/goldcrate,
/obj/machinery/light/small/directional/west,
/turf/open/floor/mineral/plastitanium,
/area/shuttle/abandoned/bar)
"Jt" = (
/obj/effect/turf_decal/stripes/line{
	dir = 6
	},
/turf/open/floor/mineral/titanium/tiled,
/area/shuttle/abandoned/bar)
"JH" = (
/obj/structure/cable,
/turf/open/floor/mineral/titanium/tiled/blue,
/area/shuttle/abandoned/medbay)
"JI" = (
/obj/machinery/atmospherics/components/unary/vent_pump/on{
	dir = 1
	},
/obj/effect/turf_decal/siding/thinplating_new/light/corner{
	dir = 4
	},
/turf/open/floor/mineral/titanium/tiled/white,
/area/shuttle/abandoned/crew)
"Kn" = (
/obj/structure/window/reinforced/shuttle,
/turf/open/floor/plating,
/area/shuttle/abandoned/medbay)
"Kx" = (
/obj/machinery/door/airlock/vault{
	name = "Secure Compartment Access"
	},
/obj/effect/turf_decal/stripes/line,
/obj/effect/turf_decal/stripes/line{
	dir = 1
	},
/obj/structure/cable,
/obj/machinery/atmospherics/pipe/smart/manifold4w/supply/hidden,
/turf/open/floor/mineral/titanium/tiled,
/area/shuttle/abandoned/bar)
"KG" = (
/obj/machinery/atmospherics/components/unary/vent_pump/on{
	dir = 8
	},
/obj/structure/closet/firecloset/full,
/obj/machinery/light/small/directional/south,
/turf/open/floor/mineral/titanium/yellow,
/area/shuttle/abandoned/bar)
"Lf" = (
/obj/effect/turf_decal/tile/neutral/fourcorners,
/turf/open/floor/iron/dark,
/area/shuttle/abandoned/bar)
"Li" = (
/obj/structure/sign/departments/medbay/alt/directional/north,
/obj/effect/turf_decal/stripes/line{
	dir = 5
	},
/obj/machinery/jukebox,
/obj/structure/sign/nanotrasen{
	pixel_x = 32
	},
/turf/open/floor/mineral/titanium/tiled,
/area/shuttle/abandoned/bar)
"Lm" = (
/obj/structure/dresser,
/obj/machinery/button/door/directional/north{
	id = "quaterts";
	name = "Bathroom Bolt Control";
	specialfunctions = 4;
	normaldoorcontrol = 1
	},
/obj/structure/closet/emcloset/wall{
	pixel_x = 30
	},
/obj/machinery/atmospherics/components/unary/vent_pump/on{
	dir = 8
	},
/turf/open/floor/carpet/royalblue,
/area/shuttle/abandoned/crew)
"Mi" = (
/obj/structure/drain,
/obj/machinery/shower/directional/south,
/turf/open/floor/mineral/titanium/tiled/blue,
/area/shuttle/abandoned/crew)
"Mo" = (
/obj/effect/turf_decal/stripes/line{
	dir = 1
	},
/obj/effect/turf_decal/stripes/line,
/obj/machinery/atmospherics/pipe/smart/manifold4w/supply/hidden,
/obj/structure/cable,
/turf/open/floor/mineral/titanium/tiled,
/area/shuttle/abandoned/bar)
"MP" = (
/obj/machinery/door/airlock/medical{
	name = "Bathroom";
	id = "bath_whiteship"
	},
/obj/machinery/atmospherics/pipe/smart/manifold4w/supply/hidden,
/turf/open/floor/mineral/titanium/tiled/white,
/area/shuttle/abandoned/crew)
"MR" = (
/obj/machinery/atmospherics/pipe/smart/manifold4w/supply/hidden,
/turf/open/floor/mineral/titanium,
/area/shuttle/abandoned/bar)
"NB" = (
/obj/effect/turf_decal/stripes/line,
/obj/structure/cable,
/obj/machinery/atmospherics/pipe/smart/manifold4w/supply/hidden,
/turf/open/floor/mineral/titanium/tiled,
/area/shuttle/abandoned/bar)
"Ps" = (
/obj/machinery/power/shuttle_engine/propulsion{
	dir = 8
	},
/turf/open/floor/plating,
/area/shuttle/abandoned/engine)
"Qo" = (
/obj/machinery/vending/boozeomat/cafe,
/turf/closed/wall/mineral/titanium,
/area/shuttle/abandoned/bar)
"QC" = (
/obj/structure/table/reinforced,
/obj/machinery/button/door{
	pixel_x = -6;
	pixel_y = 6;
	name = "Bridge Blast Shutters Control";
	id = "whiteship_blast"
	},
/obj/machinery/button/door{
	pixel_x = -6;
	pixel_y = -3;
	normaldoorcontrol = 1;
	specialfunctions = 4;
	name = "Bridge Door Lock Control";
	id = "whiteship_bridge"
	},
/obj/machinery/airalarm/directional/north,
/obj/effect/mapping_helpers/airalarm/all_access,
/turf/open/floor/mineral/titanium/tiled/blue,
/area/shuttle/abandoned/bridge)
"Ri" = (
/obj/effect/turf_decal/tile/neutral/fourcorners,
/obj/machinery/door/airlock/shuttle{
	name = "E.V.A Gear"
	},
/obj/machinery/atmospherics/pipe/smart/manifold4w/supply/hidden,
/turf/open/floor/iron/dark,
/area/shuttle/abandoned/bar)
"RN" = (
/obj/effect/turf_decal/stripes/line,
/obj/structure/chair{
	dir = 4
	},
/obj/machinery/firealarm/directional/south,
/mob/living/simple_animal/hostile/nanotrasen/ranged/smg,
/turf/open/floor/mineral/titanium/tiled,
/area/shuttle/abandoned/bar)
"RW" = (
/turf/closed/wall/mineral/titanium,
/area/shuttle/abandoned/engine)
"Sh" = (
/obj/effect/turf_decal/stripes/line{
	dir = 8
	},
/obj/structure/cable,
/obj/machinery/atmospherics/pipe/smart/manifold4w/supply/hidden,
/turf/open/floor/mineral/titanium/tiled,
/area/shuttle/abandoned/bar)
"Sm" = (
/obj/structure/closet/crate/freezer,
/obj/effect/spawner/random/food_or_drink/donkpockets,
/obj/effect/spawner/random/food_or_drink/donkpockets,
/obj/effect/spawner/random/food_or_drink/donkpockets,
/obj/item/reagent_containers/cup/glass/waterbottle/tea/strawberry,
/obj/item/reagent_containers/cup/glass/waterbottle/tea/strawberry,
/obj/item/reagent_containers/cup/glass/waterbottle/tea/strawberry,
/obj/effect/turf_decal/box/corners,
/obj/effect/turf_decal/box/corners{
	dir = 8
	},
/obj/item/food/vendor_snacks/mochi_ice_cream,
/obj/item/food/vendor_snacks/mochi_ice_cream,
/obj/item/food/vendor_snacks/mochi_ice_cream,
/obj/item/food/vendor_snacks/mochi_ice_cream/matcha,
/obj/item/food/vendor_snacks/mochi_ice_cream/matcha,
/obj/item/food/vendor_snacks/mochi_ice_cream/matcha,
/obj/item/food/vendor_snacks/moth_bag/cheesecake/honey,
/obj/item/food/vendor_snacks/moth_bag/cheesecake/honey,
/obj/item/food/vendor_snacks/moth_bag/cheesecake/honey,
/obj/item/food/vendor_snacks/moth_bag/cheesecake,
/obj/item/food/vendor_snacks/moth_bag/cheesecake,
/obj/item/food/vendor_snacks/moth_bag/cheesecake,
/obj/item/storage/box/foodpack/yangyu/sushi,
/obj/item/storage/box/foodpack/yangyu/sushi,
/obj/item/storage/box/foodpack/yangyu/sushi,
/obj/item/storage/box/foodpack/yangyu,
/obj/item/storage/box/foodpack/yangyu,
/obj/item/storage/box/foodpack/yangyu,
/turf/open/floor/iron/dark,
/area/shuttle/abandoned/cargo)
"Tu" = (
/obj/effect/turf_decal/stripes/line{
	dir = 1
	},
/obj/structure/table,
/obj/item/storage/box/donkpockets{
	pixel_y = 11;
	pixel_x = 9
	},
/obj/effect/spawner/random/food_or_drink/refreshing_beverage{
	pixel_y = 10;
	pixel_x = -7
	},
/obj/effect/spawner/random/food_or_drink/snack{
	pixel_x = 6;
	spawn_loot_count = 2;
	spawn_random_offset = 1
	},
/turf/open/floor/mineral/titanium/tiled,
/area/shuttle/abandoned/bar)
"TU" = (
/obj/structure/cable,
/obj/machinery/atmospherics/pipe/smart/manifold4w/supply/hidden,
/turf/open/floor/carpet/royalblue,
/area/shuttle/abandoned/crew)
"UA" = (
/obj/machinery/power/apc/auto_name/directional/east,
/obj/structure/cable,
/obj/machinery/light/small/directional/east,
/turf/open/floor/plating,
/area/shuttle/abandoned/engine)
"UL" = (
/obj/machinery/space_heater,
/obj/effect/turf_decal/bot,
/turf/open/floor/plating,
/area/shuttle/abandoned/engine)
"UR" = (
/obj/machinery/power/smes/engineering{
	charge = 1e+006
	},
/turf/open/floor/plating,
/area/shuttle/abandoned/engine)
"Vb" = (
/obj/effect/turf_decal/stripes/line,
/obj/structure/table,
/turf/open/floor/mineral/titanium/tiled,
/area/shuttle/abandoned/bar)
"Vc" = (
/obj/effect/turf_decal/stripes/line{
	dir = 1
	},
/obj/structure/sign/warning/vacuum/external/directional/north,
/obj/structure/tank_holder/oxygen{
	pixel_x = -8
	},
/obj/structure/tank_holder/oxygen{
	pixel_x = 7
	},
/turf/open/floor/mineral/titanium/tiled,
/area/shuttle/abandoned/bar)
"VJ" = (
/obj/structure/closet/crate,
/obj/effect/turf_decal/box/corners{
	dir = 8
	},
/obj/effect/turf_decal/box/corners,
/turf/open/floor/iron/dark,
/area/shuttle/abandoned/cargo)
"VL" = (
/obj/effect/turf_decal/stripes/line{
	dir = 1
	},
/obj/structure/cable,
/obj/machinery/atmospherics/pipe/smart/manifold4w/supply/hidden,
/turf/open/floor/mineral/titanium/tiled,
/area/shuttle/abandoned/bar)
"VM" = (
/obj/effect/turf_decal/bot/left,
/obj/machinery/portable_atmospherics/canister/oxygen,
/obj/machinery/light/directional/south,
/turf/open/floor/iron/dark,
/area/shuttle/abandoned/bar)
"VT" = (
/obj/machinery/suit_storage_unit/centcom,
/obj/effect/turf_decal/bot/right,
/turf/open/floor/iron/dark,
/area/shuttle/abandoned/bar)
"Wv" = (
/obj/structure/closet/cabinet,
/obj/structure/cable,
/obj/machinery/power/apc/auto_name/directional/north,
/obj/machinery/light/directional/north,
/turf/open/floor/carpet/royalblue,
/area/shuttle/abandoned/crew)
"Ww" = (
/obj/machinery/computer/camera_advanced{
	dir = 8
	},
/turf/open/floor/mineral/titanium/tiled/blue,
/area/shuttle/abandoned/bridge)
"WP" = (
/obj/structure/table/reinforced,
/obj/item/radio{
	pixel_x = 5;
	pixel_y = 5
	},
/obj/item/radio{
	pixel_x = d;
	pixel_y = 2
	},
/obj/machinery/cell_charger,
/turf/open/floor/mineral/titanium/tiled/blue,
/area/shuttle/abandoned/bridge)
"WY" = (
/obj/machinery/door/airlock/medical{
	name = "Infirmary"
	},
/obj/structure/cable,
/obj/machinery/atmospherics/pipe/smart/manifold4w/supply/hidden,
/turf/open/floor/mineral/titanium/tiled/white,
/area/shuttle/abandoned/medbay)
"Xe" = (
/obj/machinery/atmospherics/pipe/smart/manifold4w/supply/hidden,
/turf/open/floor/mineral/plastitanium,
/area/shuttle/abandoned/bar)
"Yl" = (
/obj/machinery/power/shuttle_engine/heater{
	dir = 8
	},
/turf/open/floor/plating,
/area/shuttle/abandoned/engine)
"Ys" = (
/obj/structure/cable,
/obj/machinery/atmospherics/components/unary/vent_pump/on,
/turf/open/floor/mineral/titanium/tiled/white,
/area/shuttle/abandoned/medbay)
"ZB" = (
/obj/effect/turf_decal/stripes/line{
	dir = 4
	},
/turf/open/floor/mineral/titanium/tiled,
/area/shuttle/abandoned/bridge)
"ZC" = (
/obj/machinery/button/door/directional/south{
	id = "bath_shutter";
	name = "Bathroom Privacy Shutter Control"
	},
/obj/effect/turf_decal/siding/thinplating_new/light{
	dir = 1
	},
/obj/machinery/light/small/directional/south,
/turf/open/floor/mineral/titanium/tiled/white,
/area/shuttle/abandoned/crew)
"ZS" = (
/turf/open/space/basic,
/area/space)
"ZZ" = (
/obj/effect/turf_decal/stripes/line{
	dir = 10
	},
/obj/item/kirbyplants/random,
/obj/machinery/light/small/directional/west,
/turf/open/floor/mineral/titanium/tiled,
/area/shuttle/abandoned/bar)

(1,1,1) = {"
ZS
ZS
ZS
ZS
RW
lI
Ps
uU
RW
ZS
ZS
ZS
"}
(2,1,1) = {"
ZS
ZS
ZS
ZS
RW
rZ
rZ
rZ
RW
ZS
ZS
ZS
"}
(3,1,1) = {"
ZS
ZS
ZS
RW
RW
rR
UL
vi
RW
RW
ZS
ZS
"}
(4,1,1) = {"
ZS
lI
uU
RW
px
ct
rU
wN
pr
RW
lI
uU
"}
(5,1,1) = {"
ZS
Yl
Yl
RW
UR
UA
CR
ku
Jj
RW
Yl
Yl
"}
(6,1,1) = {"
ZS
ht
ht
ht
ht
ht
mg
ht
FL
FL
FL
FL
"}
(7,1,1) = {"
ZS
ht
qA
VM
ht
ba
Mo
Jq
FL
rB
VJ
bV
"}
(8,1,1) = {"
ZS
aY
Lf
zi
Ri
Xe
wu
fM
zg
aS
ge
bV
"}
(9,1,1) = {"
ZS
ht
VT
VT
ht
rg
Mo
rA
FL
qs
Sm
bV
"}
(10,1,1) = {"
ZS
ht
ht
ht
ht
ht
Kx
ht
FL
FL
FL
FL
"}
(11,1,1) = {"
ZS
uj
lc
BQ
ht
uy
Sh
ZZ
gl
fH
DL
gl
"}
(12,1,1) = {"
ZS
Dt
DM
MR
jF
Eu
hj
wi
MP
aV
JI
vr
"}
(13,1,1) = {"
ZS
Dc
GM
KG
ht
Vc
hj
al
gl
Mi
ZC
gl
"}
(14,1,1) = {"
ZS
AF
AF
AF
AF
Tu
hj
RN
gl
gl
vE
gl
"}
(15,1,1) = {"
ZS
AF
jE
rd
AF
gy
hj
Vb
gl
mS
BS
gl
"}
(16,1,1) = {"
ZS
Kn
DA
gf
Kn
DF
hj
FX
gl
Wv
gn
Bk
"}
(17,1,1) = {"
ZS
Kn
JH
Ys
WY
VL
hj
NB
cQ
TU
gn
Bk
"}
(18,1,1) = {"
ZS
AF
lR
Db
AF
Li
ip
Jt
gl
Lm
pc
gl
"}
(19,1,1) = {"
ZS
AF
AF
AF
AF
ht
FQ
Qo
gl
gl
gl
gl
"}
(20,1,1) = {"
ZS
ZS
la
bQ
ur
Bn
qI
ij
mM
kZ
la
ZS
"}
(21,1,1) = {"
ZS
ZS
lL
WP
ly
ZB
kO
ZB
Cy
vN
la
ZS
"}
(22,1,1) = {"
ZS
ZS
Am
Am
QC
hK
IF
Ww
mC
Am
Am
ZS
"}
(23,1,1) = {"
ZS
ZS
ZS
Am
la
la
la
la
la
Am
ZS
ZS
"}
(24,1,1) = {"
ZS
ZS
ZS
ZS
ZS
ZS
ZS
ZS
ZS
ZS
ZS
ZS
"}
(25,1,1) = {"
ZS
ZS
ZS
ZS
ZS
ZS
ZS
ZS
ZS
ZS
ZS
ZS
"}
